~~~~~~~~~~~~~~~~~~~~~~~~~~~~~~~~~~~~|
~~~~~~~~~...........................|
~~~~~~~~~...........P...............|
~~~~~~~~~...........................|
~~~~~~~~~...........................|
~~~~~~~~~......................*****|
...............~~~~~~~~........*****|
****...........~~~~~~~~........*****|
****...........~~~~~~~~.....********|
**......~~~~................********|
**......~~~~................~~~~~~~~|
........~~~~................~~~~~~~~|
............................~~~~~~~~|
~~~~~~~~~~~~~~~~~~~~~~~~~~~~~~~~~~~~|
~~~~~~~~~~~~~~~~~~~~~~~~~~~~~~~~~~~~|
