***********...**********************|
***********.........................|
***********.........................|
*...................................|
*...................................|
*...................................|
*...............********************|
*...............********************|
*...............********************|
................************........|
................************........|
................************........|
....................................|
................................P...|
....................................|
